#################
#S   #     #    #
### ### ### # # #
#     #   # # # #
# ##### # # # # #
#   #   #   #   #
# # # ####### ###
# # #       #   #
# # ####### ### #
# #       #    E#
#################