#####################
#S      #       #   #
# ####### ##### # # #
#       #     # # # #
####### # ### # # # #
#     # # #   #   # #
# ### # # # ####### #
# #   #   #       # #
# # ########### # # #
# #           # #   #
# ########### # ### #
#           #      E#
#####################