#############################
#S      #       #       #   #
# ##### # ##### # ##### # # #
# #   # #     # #     # # # #
# # # # ##### # ##### # # # #
#   # #     # #   #   #   # #
##### ##### # ### # ####### #
#     #   # #   # #       # #
# ### # # # ### # ####### # #
# #   # # #   # #       # # #
# # ### # ### # ####### # # #
# #     #     #   #     #   #
# ####### ####### # #########
#       #       # #         #
####### # ##### # ######### #
#     # # #   # #       #   #
# ### # # # # # ####### # ###
# #   #   # # #   #   # #   #
# # ####### # ### # # # ### #
# #       # #   #   # #   # #
# ####### # ### ##### ### # #
#       #   #     #       #E#
#############################