###############
#S      #     #
# ##### # ### #
#     # #   # #
### # # ### # #
#   # #     # #
# ### ##### # #
#     #   #  E#
###############